3 1
46 16
############################################################################################
#..@....#...........#...#.........#.......#.............#.....#.#.....#...#.......#.........
#.#.#####.#########.#.#.#.#.#####.#.#######.#########.#.#.###.#.#.#.#.###.#.#####.#.#####.##
#.#.......#.......#...#...#.#...#.#.........#.#.......#...#.#.#...#.#...#.......#...#...#...
###.#######.#.#############.#.###.#.#########.#.#.#########.#.#.###.###.#######.#####.#.###.
#.#.........#.#...#.....#...#.....#...#.......#.#.#...#...#...#.#...#...#...#.....#...#.#...
#.#############.#.#.###.#.###.#######.###.#.###.#.#.#.###.#.#####.###.###.#.#####.#.###.#.#.
#.#.............#...#...#.#.#.#.....#...#.#.#...#.#.#...#.........#...#...#.#...#.#.#.#.#.#.
#.#.#################.###.#.#.#.#.#####.###.#.#####.###.###########.#####.#.#.#.###.#.#.#.#.
#.#.#.#.........#.#...#...#.#.#.#.#...#.#...#.........#.#.....#...........#...#.....#.#.#.#.
#.#.#.#.#####.#.#.#.###.###.#.#.###.#.#.#.#############.#.###.#######################.#.#.#.
#...#.#.#.....#.#.#.....#.#...#.....#...#.........#.#...#.#...#.....#.............#...#...#.
#####.#.#.#####.#.#######.#.###.#########.#####.#.#.#.###.#.###.###.#.###.#######.###.#####.
#.....#.#.#...#.......#.....#...#.#...#...#...#.#...#.#...#.#.....#.#...#.#.....#.....#...#.
#.#.###.#.#.#.#####.###.#####.###.#.#.#.###.#.#.#####.#.###.#.#####.###.###.###.#####.#.#.#.
#.#.#...#...#.#...#.#...#...#.#.....#.......#.#.....#...#.#.#.#...#...#.#...#.#.#.....#.#.#.
#.#.#.#######.#.#.###.#####.#.#.#############.~####.#####.#.#.#.#.###.#.#.###.#.#####.#.###.
#.#.#...#.....#.#.....#.....#.#.#...#...#...#.#...........#...#.#.....#.......#.....#...#...
#.#####.#.###.#.#######.#.#.#.#.#.#.#.#.###.#.#.#.#############.###################.#.###.##
#.....#.#.#...#.....#...#.#.#.#...#.#.#...#...#.#.#...........#...#...#.....#.......#.#...#.
#####.#.#.#.#######.#####.###.#####.#.###.#####.###.#####.###.###.#.#.#.###.#.#######.#.###.
#...#...#.#...#...#.#...#.........#.#.#.#.....#.....#.....#.....#.#.#.#.#...#.......#.#.#...
#.#.###.#.###.#.#.#.#.#.#########.###.#.#####.#######.###########.#.#.#.#.###.#####.#.#.#.#.
#.#...#.#...#...#.#.#.#.........#.....#.....#.#.....#.#...#.......#.#...#.#.#...#...#.#.#.#.
#.###.#####.#.#####.#.#########.#########.#.#.#.###.#.#.#.#.#######.#####.#.###.#.#####.#.##
#.#.#.....#.#.#.....#.#.......#.........#.#.#.#.#...#.#.#...#.......#.....#.....#.#.....#...
#.#.#####.#.#.#.#####.#.#####.#########.#.###.#.#.###.#.#####.#.#########.#######.#.#######.
#.#.....#.#.#.#...#...#...#.#.....#.....#.#...#.#.....#.....#.#...#.....#...#...#.#.........
#.#.###.#.#.#####.###.###.#.###.#.#.#####.#.###.#####.#####.#.###.#.###.###.#.#.#.#########.
#.#...#...#.....#...#.#.......#.#.#...#...#.#...#...#.#...#.#.#.#.#...#.#...#.#...#.......#.
#.###.#####.#.#####.#.#.#######.#.###.###.#.#.#.#.#.#.#.#.#.#.#.#.###.#.#.###.###.#.#####.#.
#.#.#.#.#...#.....#...#...#.....#...#...#...#.#.#.#.#.#.#...#...#...#.#.#.....#...#...#...#.
#.#.#.#.#.#####.#########.#.#######.###.###.#.###.#.###.#######.###.#.#.#############.#.###.
#.#...#.......#...........#...#.......#...#.#.#...#...#.......#.#.#.#.#...........#...#.....
#.#.#########.#######.#######.#.#########.#.#.#.#####.#######.#.#.#.#.###########.#.########
#.#.........#.#.#...#.....#.#.#.#.......#.#.#.#.#.....#.......#...#.#...#...#.#...#.#.......
#.#########.#.#.#.#.#####.#.#.#.#.#####.#.#.#.#.#.###.#.#########.#.###.#.#.#.#.###.#####.#.
#...#.....#.#...#.#.#.....#.#.#.#.#...#...#.#...#.#...#.#.....#...#.#...#.#...#.....#.....#.
#.#.#.#.###.###.#.#.###.###.#.#.#.###.#####.#####.#.###.#####.#.###.#.###.###########.#####.
#.#.#.#.#...#.#.#.#...#.....#.#.#...#.......#.....#...#.#...#.#.#.#...#.#...#.......#.#.....
#.#.###.#.###.#.#.###.#.#####.#.###.###.#####.###.#####.#.#.#.#.#.#####.#.#.#.###.#.#.#.####
#.#.#...#.#...#.#.#...#.#.....#...#...#.......#...#.....#.#...#...#.....#.#.....#.#...#.....
#.#.#.#.#.###.#.#.#.#####.###########.#############.#####.###.###.#.###.#.#######.#########.
#.#.#.#.#...#...#.#...#...#.....#...#.#...........#.#.....#.....#.#.#.#.#.#...#...#.......#.
###.#.#####.#####.###.#.###.###.#.#.#.#.#########.#.#.###.#######.#.#.#.#.#.###.###.#####.#.
#...#.....#.....#.#.#.#.....#.#.#.#.#...#.......#...#...#.....#...#.#.#...#...#.#.....#...#.
#.#####.#.#####.#.#.#.#.#####.#.#.#.#######.###.#######.#####.#.###.#.#######.#.#####.#.###.
#.....#.#.#...#...#...#.....#.#...#...#...#...#...#...#.#...#.#...#...........#.#...#.#...#.
#####.#.#.#.#.#####.#######.#.#####.#.#.#.###.###.###.#.#.#.#.###.#########.###.#.#.#.###.#.
#.....#.#...#...#...#.....#.....#...#...#.....#.......#...#.#...#.#.......#.#...#.#.#...#...
#.#####.#####.###.###.#####.#####.#############.###########.###.#.#.#######.#.###.#.###.####
#...#...#.....#...#.........#.....#...#.......#.#.........#.#.#...#.#...#...#.....#...#.#...
#.#.###.#.###.#.###.#########.#####.###.#####.#.#.#####.###.#.#####.#.#.#.###########.#.###.
#.#...#.#.#.#.#...#.....#...#.#.#.....#.....#.#.#.....#...#.#.#.....#.#...#...#...#...#.....
#####.#.#.#.#.###.###.###.#.#.#.#.###.###.###.#.#####.###.#.#.#.###.#.#####.#.#.#.#.#######.
#.....#.#.#.....#...#.#...#...#...#.#...#.#...#.#...#.#...#.#.#...#.#.#.....#.#.#.#.#.....#.
#.#####.#.#########.###.#########.#.#.###.#.###.###.#.#.###.#.###.#.#.#.#####.###.#.#.###.#.
#...#...#.........#.....#.......#...#.....#.#...#...#.#.....#.#...#...#.#.#.......#.#.#...#.
#.#.#.###########.#########.###.###########.#.###.###.#######.#.#####.#.#.#.#######.#.#.###.
#.#.#...#.......#...........#...#...........#.#.#...#...#...#...#...#.#.#.#...#.....#.#.....
#.#.###.#######.###.#.#######.###.###.#####.#.#.#.#.###.#.#.###.#.#.#.#.#.###.#.#######.####
#.#.#.#...#...#...#.#.#...#.......#...#...#.#.#...#...#...#...#.#.#.#...#.....#.#.....#.....
#.#.#.###.#.#.###.#.###.#.#.###########.#.#.#.#####.#########.###.#.###########.#.###.#####.
#.#.#.#...#.#.....#.....#.#.#...........#.#.#.....#.........#.....#...........#.....#...#...
###.#.#.###.#####.#######.#.#.###########.#.#####.#########.#################.#####.###.#.##
#...#.#.#.....#.#.#...#...#.#.#.....#.....#.#...........#.....#.#.........#.#...#.....#.#...
#.###.#.#.###.#.#.#.#.#.###.#.###.#.#.#####.#.#########.#.###.#.#.###.###.#.###.#######.###.
#.#...#.#...#.#...#.#.#.#...#.#...#.#.....#.#.....#...#...#.....#.#.#...#.#...#.#.....#...#.
#.###.#.#####.#.#####.#.###.#.#.#.#######.#####.###.#.###########.#.###.#.#.###.#.###.###.#.
#...#.........#.......#...#.#.#.#.#.......#...#.#...#...........#.#.#...#.#...#...#...#...#.
#.#.#####.###########.###.###.#.#.#.#.#####.#.#.#.#############.#.#.#.###.###.#####.###.###.
#.#...#.#.#.......#.....#...#...#.#.#.#.....#...#.#...........#.#.#.#...#.......#.#.#...#...
#####.#.#.#.#####.#########.#####.#.###.#########.#.#########.#.#.#.###.#######.#.#.#.###.##
#.....#...#.#...#.........#.#.....#...........#...#...#.....#.#...#.#...#.........#...#.#...
#.#####.###.###.#########.#.#.#################.#######.###.#.#####.#.#################.###.
#.#.....#.#.....#.#.....#.#.#.#...#...#.........#.......#.......#...#.....#...........#.....
#.#.#####.#####.#.#.#.#.#.#.#.#.###.#.#.#########.#######.#####.#.#####.#.#.#########.#.####
#.#.#...#...#...#...#.#.#.#.....#...#...#.........#.....#.#...#...#...#.#.#.#.......#.#.#...
#.#.#.#.###.#.###.###.#.#.#####.#.###########.###.###.###.#.#.#.###.#.###.#.#.#.###.#.#.###.
#.#...#...#.#...#...#.#.#.....#.#...#...#...#.#...#...#...#.#.#.#...#.....#.#.#.#...#.#...#.
#.#######.#.###.###.#.#######.#####.#.#.#.#.###.###.###.###.#.###.###.#####.###.#.###.###.#.
#.#.....#.#.#...#...#.....#.#.....#...#...#.#...#.#...#.#.#.#.....#...#...#...#.#...#...#.#.
#.#.#####.#.#.###.#####.#.#.#####.#########.#.###.#.#.#.#.#.#######.###.#.###.#.#####.#.#.#.
#.#.#.....#.#.#...#...#.#.....#...#.......#.#.#.....#.#.#.#.....#.....#.#.......#.....#.#...
#.#.#.#####.#.#.###.#.#.#####.#.#.#.###.###.#.#####.#.#.#.#####.#######.#########.#####.###.
#.#.#.......#.#.#...#.#.#...#.#.#...#...#...#.....#.#.#.#.....#...#.....#...#.....#.......#.
#.#.#.#######.#.#.#####.#.###.#.#######.#.#####.#.#.#.#.#.###.###.#.#####.###.#############.
#.#...#.....#.#...#...#.#.#...#.#.....#.#.....#.#.#.#...#...#...#.#.......#...#.........#...
#.#####.###.#.#####.#.#.#.#.###.#.###.#######.###.#.#######.###.#.#####.###.#.#.#######.#.##
#.#...#...#.#.....#.#.#.#...#.#...#.#.........#...#.....#...#.#.#.....#.#...#.#.#.#.....#...
#.#.#.###.#.#####.#.#.#.#.###.#####.###########.#######.#.###.#.###.###.#.#####.#.#.#######.
#...#.....#.........#...#.......................#.........#.......#.....#.........#.........
