8 1
11 2
######################
#.......@.....#.......
#.#.#####.#~###.#####.
#.#.......#.....#.#...
#######.#########.#.#.
#.....#.....#.....#.#.
#.###.#####.###.###.#.
#.#...#...#...#.#...#.
#.#.#####.###.#.#.###.
#.#.#...#...#...#.#.#.
#.#.#.#.###.###.#.#.#.
#.#...#...#...#.#.#...
#.#######.#.#.#.#.####
#.#.......#.#...#.#...
#.#.#########.###.#.#.
#.#.........#...#...#.
###########.#####.###.
#.........#.....#...#.
#.#######.#####.#####.
#.......#.#.....#.....
#.#####.###.#####.###.
#.....#...........#...