1 9
9 1
######################
#.......#~..#.....#...
###.###.###.#.#####.#.
#...#.......#...#...#.
#.#########.###.#.###.
#.......#.#.#.#.#.#.#.
#.#####.#.#.#.#.#.#.#.
#.#.....#.....#.#.#...
#.#.#####.#####.#.#.##
#@#.#.....#.....#.#...
#.#.#######.#####.####
#.#.......#.....#.....
#.#######.#####.#.###.
#.#.....#.....#.#.#...
#.#.###.#.###.#.###.##
#.#.#.#.#.#...#...#...
#.#.#.#.#.#######.###.
#.#.#...#.#.....#...#.
#.#.###.#.#.###.###.#.
#.#...#...#.#.....#.#.
#.###.#####.#.#####.#.
#...#.......#.........